NO ./images/xpm/game/red_wall.xpm

SO ./images/xpm/game/black_wall.xpm
EA ./images/xpm/game/white_wall.xpm

WE ./images/xpm/game/violet_wall.xpm


F  50,200,100   

C  255,1,0





           1111111111111111
         11100000000000000111
       111000000010000000001111
      11000000001110E0000111111
     110000000000100000000111111
    11000000000000000000011111111
    1000000000000000000001111111111
    1000000000000011111111111111111
    110000000000111111111111111111
     1100000000111111111111111111
      11000000011111101111111111
       111000001111100011111111
         11100001111101111111
           1111111111111111
